xxxxxxxxxxxxxxxxxxxxxxxxxxxxxxx
x  p                      e   x
x       x    xxxxxxxxxx       x
x       x    x d      x       x
x    e  x    x    r   x       x
x       x    x d    d x       x
x            xxxx  xxxx       x
x                             x
x       xxxxxxxxx     xxxxxxxxx
x       x             e       x
x   e   x                     x
x       x    e             s  x
x                             x
xxxxxxxxxxxxxxxxxxxxxxxxxxxxxxx

